NO ./textures/greystone.xpm
SO ./textures/purplestone.xpm
WE ./textures/redbrick.xpm
EA ./textures/wood.xpm

F 1,35,122
C 254,134,164
F 1,35,122

111111111111
1001 1000001
100111000001
1000000N0001
111111111111
