NO ./textures/mossy.xpm
SO ./textures/netherrack_01.xpm
WE ./textures/basalt_top.xpm
EA ./textures/mossy.xpm

F 255,35,122
C 255,134,164


		1111111111111111111111111
		1000000000110000001000001
		1011000001110000011100011
		1001000000000000001000001
111111111011000001110000000000001
100000000011000001110111110111111
11110111111111011100000010001
11110111111111011101010010001
11000000110101011100000010001
10000000000000001100000010001
10000000000000001101010010001
11000001110101011111011110W0111
11101111111010111011110100011
1111111 1111111 111111111111
